1111111111111111111111111111
11100000000000000000000000E1
1000010101110000111011100001
100001E10CV100001V0010100001
1000011101110110111011100001
1000000101C00000CV1010000001
1P0000C101110000111010000001
1101V000000000000000C0000001
11011111000000000C1000000001
110111000000000C1110C0000001
11C00C011E000001111V000000E1
1E0000000000000000000000V001
1111111111111111111111111111